த=தா
தரு=தா
தர்=தா
வ=வா
வரு=வா
வர்=வா
வெ=வே
செ=சா
நொ=நோ
கேட்=கேள்
சென்=செல்
வென்=வெல்
கற்=கல்
விற்=வில்
அழ்=அழு
எழ்=எழு
நின்=நில்
நிற்=நில்
தோற்=தோல்
சொன்=சொல்
கொண்=கொள்
கண்=காண்
ஆண்=ஆள்
புற்=புல்
முட்=முள்
நாட்=நாள்
சுவற்=சுவறு
கண்=காண்-1
ஆண்=ஆள்-1
வீட்டு=வீடு
காட்டு=காடு
ஓட்டு=ஓடு
பயின்=பயில்
கருத்த=கருப்பு